backdrop = Dark_Forest_Background.jpg
00,00,00,00,00,00,00,00,00,00,00,00,00,00,00,00,00,00,00,00,00,00,00,00,00,00,00
00,00,00,00,00,00,00,00,00,00,00,00,00,00,00,00,00,00,00,00,00,00,00,00,00,00,00
00,00,00,00,00,00,00,00,00,00,00,00,00,00,00,00,00,00,00,00,00,00,00,00,00,00,00
00,06,00,00,00,00,00,03,01,01,01,01,01,01,04,00,00,02,02,00,00,00,00,02,02,00,00
01,01,01,01,04,00,00,00,00,00,00,00,00,00,00,00,00,02,02,00,07,00,00,02,02,00,00
00,00,00,00,00,00,00,00,00,00,00,00,00,00,00,00,00,02,02,02,02,02,02,02,02,00,00
00,00,00,00,00,00,00,00,00,00,00,00,00,00,00,00,00,02,02,02,02,02,02,02,02,00,00
00,00,00,00,00,00,00,00,00,00,00,00,00,00,00,00,00,02,02,02,02,02,02,02,02,00,00
00,00,00,00,00,00,00,00,00,00,00,00,00,00,00,00,00,02,02,02,02,02,02,02,02,00,00
00,00,00,00,00,00,00,00,00,00,00,00,00,00,00,00,00,02,02,02,02,02,02,02,02,00,00
00,00,00,00,00,00,00,00,00,00,00,00,00,00,00,00,00,02,02,02,02,02,02,02,02,00,00
07,00,00,00,00,00,00,00,00,00,00,00,00,00,00,00,00,02,02,02,02,02,02,02,02,00,00
02,00,00,00,00,00,00,00,00,00,00,00,00,00,00,00,00,02,00,00,00,00,00,00,00,00,00
02,00,00,00,00,00,00,00,00,10,00,00,00,00,00,00,00,02,00,00,00,00,00,00,09,00,00
01,01,01,01,01,01,01,01,01,01,01,01,01,01,01,01,01,01,01,01,01,01,01,01,01,01,00
00,00,00,00,00,00,00,00,00,00,00,00,00,00,00,00,00,00,00,00,00,00,00,00,00,00,00
00,00,00,00,00,00,00,00,00,00,00,00,00,00,00,00,00,00,00,00,00,00,00,00,00,00,00
00,00,00,00,00,00,00,00,00,00,00,00,00,00,00,00,00,00,00,00,00,00,00,00,00,00,00
00,00,00,00,00,00,00,00,00,00,00,00,00,00,00,00,00,00,00,00,00,00,00,00,00,00,00
00,00,00,00,00,00,00,00,00,00,00,00,00,00,00,00,00,00,00,00,00,00,00,00,00,00,00
